Power: ???
E-mail:     KEY_MAIL
www:        KEY_HOMEPAGE
Close:      KEY_LEFTALT KEY_F4
Green (A):  KEY_LEFTCTRL KEY_LEFTALT KEY_A
            KEY_LEFTCTRL KEY_LEFTALT KEY_1
            KEY_LEFTCTRL KEY_LEFTALT KEY_F1
Orange (B): KEY_LEFTCTRL KEY_LEFTALT KEY_B
            KEY_LEFTCTRL KEY_LEFTALT KEY_2
            KEY_LEFTCTRL KEY_LEFTALT KEY_F2
Blue (C):   KEY_LEFTCTRL KEY_LEFTALT KEY_C
            KEY_LEFTCTRL KEY_LEFTALT KEY_3
            KEY_LEFTCTRL KEY_LEFTALT KEY_F3
Yellow (D): KEY_LEFTCTRL KEY_LEFTALT KEY_D
            KEY_LEFTCTRL KEY_LEFTALT KEY_4
            KEY_LEFTCTRL KEY_LEFTALT KEY_F4
Previous:   KEY_PREVIOUSSONG
Next:       KEY_NEXTSONG
Rewind:     KEY_LEFT KEY_LEFTCTRL KEY_LEFTSHIFT
            KEY_LEFTCTRL KEY_LEFTSHIFT KEY_B
Forward:    KEY_RIGHT KEY_LEFTCTRL KEY_LEFTSHIFT
            KEY_LEFTCTRL KEY_LEFTSHIFT KEY_F
PlayPause:  KEY_PLAYPAUSE
Stop:       KEY_STOPCD
Fullscreen: ALT KEY_ENTER
            CTRL KEY_3
Mute:       KEY_MUTE
DownVol:    KEY_VOLUMEDOWN
UpVol:      KEY_VOLUMEUP
Tab:        KEY_TAB
Up:         KEY_UP
Windows:    KEY_RIGHTMETA
Backspace:  KEY_BACKSPACE
Left:       KEY_LEFT
Enter:      KEY_ENTER
Right:      KEY_RIGHT
PageUp:     KEY_PAGEUP
Folder:     CTRL KEY_O
Down:       KEY_DOWN
Escape:     KEY_ESC
PageDown:   KEY_PAGEDOWN
ChangeFold: ALT KEY_TAB
MyPC:       KEY_LEFTMETA KEY_E
Desktop:    KEY_LEFTMETA KEY_D

